#####################################################
#####################################################
##                                                 ##
##                                                 ##
##                                                 ##
##                                                 ##
##                                                 ##
##                                                 ##
##                                                 ##
##                                                 ##
##                                                 ##
##                                                 ##
##                       A                         ##
##                                                 ##
##                                                 ##
##                                                 ##
##                                                 ##
##                                                 ##
##                                                 ##
##                                                 ##
##                                                 ##
##                                                 ##
##                                                 ##
##                                                 ##
##                                                 ##
#####################################################
#####################################################
