###################################################
#                                                 #
#                                                 #
#                                                 #
#                                                 #
#                                                 #
#                                                 #
#                                                 #
#                                                 #
#                                                 #
#                                                 #
#                       A                         #
#                                                 #
#                                                 #
#                                                 #
#                                                 #
#                                                 #
#                                                 #
#                                                 #
#                                                 #
#                                                 #
#                                                 #
#                                                 #
#                                                 #
###################################################
